+-+-+-+-+-+-+-+-+-+-+-+-+-+-+-+-+
|                               |
+ +-+-+-+-+-+-+-+-+-+-+-+-+-+-+ +
| |                             |
+ + +-+-+-+-+-+-+-+-+-+-+-+-+-+ +
| | |       |   |   |         | |
+ + + +-+ +-+ + + + + +-+-+-+ + +
| | | | |     | | | | |   |   | |
+ + + + +-+-+-+ + + + +-+ + +-+ +
| | | |         | | | |     |   |
+ + + + +-+-+-+ + + + +-+ +-+ + +
| | | | |   | | | |   |   | | | |
+ + + + + + + +-+ +-+-+ +-+ + + +
| | | |   | |     |       |   | |
+ + + +-+-+ + +-+-+-+ +-+-+ + + +
| | | |     | |   |     | | | | |
+ + + + + +-+ + + + +-+-+ + + + +
| | | | | |   |         |   | | |
+ + + + +-+ +-+-+-+-+-+ + + + + +
| | | | |     |       | | | | | |
+ + + + + +-+-+-+-+ + + + +-+-+ +
| | | | |   |       | | |     | |
+ + + + + + + +-+ +-+ + +-+-+ + +
| | | |   | |       | |     | | |
+ + + +-+-+ +-+ +-+ + +-+-+ + + +
| |   |     |       | |   | | | |
+ +-+ + +-+-+ +-+ +-+ + + + + + +
|   | |             |   |   | | |
+ + + +-+-+-+-+-+-+-+-+-+-+-+ + +
| | |                         | |
+ + +-+-+-+-+-+-+-+-+-+-+-+-+-+ +
| |                             |
+-+-+-+-+-+-+-+-+-+-+-+-+-+-+-+-+
